##################
#P   #       #   #
### # ##### ### ##
#   #   #   #    #
# ##### # ### ## #
#     # #   # ## #
# ### # ### #    #
# #   #   # ######
# # ##### #     T#
# #     # ### ## #
#   ###   A   # S#
##################