###############
#P     #     T#
# ### ### ### #
#   #     #   #
### ##### # # #
#   #   # # # #
# ### # # # # #
#   T #   #   #
# ##### ### #S#
###############